CACTTCGA	CACTTCGA
TGAAGAGA	TGAAGAGA
CTGAGCCA	CTGAGCCA
CCTCTATC	CCTCTATC
AGCCATGC	AGCCATGC
CCATCCTC	CCATCCTC
CGCATACA	CGCATACA
CGACTGGA	CGACTGGA
TGGCTTCA	TGGCTTCA
CGGATTGC	CGGATTGC
ATAGCGAC	ATAGCGAC
CTCAATGA	CTCAATGA
AGGCTAAC	AGGCTAAC
AGCACCTC	AGCACCTC
AGATGTAC	AGATGTAC
AAGAGATC	AAGAGATC
GAGCTGAA	GAGCTGAA
TGGTGGTA	TGGTGGTA
CCGACAAC	CCGACAAC
CAAGACTA	CAAGACTA
GTACGCAA	GTACGCAA
CCTAATCC	CCTAATCC
CTGGCATA	CTGGCATA
CACCTTAC	CACCTTAC
GGTGCGAA	GGTGCGAA
ACACGACC	ACACGACC
TTCACGCA	TTCACGCA
CGACACAC	CGACACAC
GTCGTAGA	GTCGTAGA
CAGCGTTA	CAGCGTTA
TGGAACAA	TGGAACAA
TCTTCACA	TCTTCACA
GAATCTGA	GAATCTGA
GGAGAACA	GGAGAACA
GCTCGGTA	GCTCGGTA
GATGAATC	GATGAATC
GTCTGTCA	GTCTGTCA
ACAGATTC	ACAGATTC
AACTCACC	AACTCACC
GCCAAGAC	GCCAAGAC
TCTAATCC	CCTAATCC
CGGCTGGA	CGACTGGA
CTCAATGG	CTCAATGA
AGGATTGC	CGGATTGC
CGATCCTC	CCATCCTC
CGGATTTC	CGGATTGC
CAGAGCCA	CTGAGCCA
AGCCATAC	AGCCATGC
CGATGTAC	AGATGTAC
ATGGCGAC	ATAGCGAC
CCATCCGC	CCATCCTC
AAGAGCTC	AAGAGATC
AGCGCCTC	AGCACCTC
CAATCCTC	CCATCCTC
AGAACCTC	AGCACCTC
CGCATAGA	CGCATACA
CCGCCAAC	CCGACAAC
CGAATGGA	CGACTGGA
TGAAGGGA	TGAAGAGA
CGCAATGA	CTCAATGA
ATAGCGGC	ATAGCGAC
ATCGCGAC	ATAGCGAC
ATCAATGA	CTCAATGA
TGGATTCA	TGGCTTCA
TGGCTTGA	TGGCTTCA
TTGCTTCA	TGGCTTCA
GGAAGAGA	TGAAGAGA
AGAGCGAC	ATAGCGAC
CACATACA	CGCATACA
TGGCGGTA	TGGTGGTA
CCTCTCTC	CCTCTATC
CCAACCTC	CCATCCTC
CGGCTAAC	AGGCTAAC
TTCACGAA	TTCACGCA
AGCACCGC	AGCACCTC
ANACGACC	ACACGACC
GGGCTGAA	GAGCTGAA
AGATGTGC	AGATGTAC
TCAAGAGA	TGAAGAGA
CCGAGCCA	CTGAGCCA
CGACACAA	CGACACAC
GTACGCCA	GTACGCAA
CTAGCGAC	ATAGCGAC
CGTATACA	CGCATACA
CTCATACA	CGCATACA
AGGCGAAC	AGGCTAAC
CTAAATGA	CTCAATGA
CCATGCTC	CCATCCTC
CTTGCATA	CTGGCATA
CTGAGTCA	CTGAGCCA
TGGTGGTC	TGGTGGTA
ATGCTAAC	AGGCTAAC
CTGAACCA	CTGAGCCA
TNCACGCA	TTCACGCA
CGAATACA	CGCATACA
CCTCGATC	CCTCTATC
CCACCCTC	CCATCCTC
CTGATTGC	CGGATTGC
CGGCTTCA	TGGCTTCA
TGGAGGTA	TGGTGGTA
CACTTGGA	CACTTCGA
TGTAGAGA	TGAAGAGA
CGGATACA	CGCATACA
GATGAATA	GATGAATC
CCATACTC	CCATCCTC
CTGAATGA	CTCAATGA
AAGAGAGC	AAGAGATC
TAAGACTA	CAAGACTA
CGTGCGAA	GGTGCGAA
TCTTCAAA	TCTTCACA
CGCACCTC	AGCACCTC
CGCACACA	CGCATACA
AGGCTAGC	AGGCTAAC
CCTCCATC	CCTCTATC
TGACTTCA	TGGCTTCA
ACCCATGC	AGCCATGC
CAACTGGA	CGACTGGA
TTCAATGA	CTCAATGA
CGGTTTGC	CGGATTGC
GTACGCAC	GTACGCAA
ATATCGAC	ATAGCGAC
AGCAGCTC	AGCACCTC
CNACACAC	CGACACAC
AGGATAAC	AGGCTAAC
TGAAGACA	TGAAGAGA
TGTGCGAA	GGTGCGAA
CCTCTAAC	CCTCTATC
CCTCTATT	CCTCTATC
GGACTGGA	CGACTGGA
AGGCTAAT	AGGCTAAC
ACAGATTA	ACAGATTC
GNCGTAGA	GTCGTAGA
ATAGCGCC	ATAGCGAC
TGGCCTCA	TGGCTTCA
CGAATTGC	CGGATTGC
AGGCCAAC	AGGCTAAC
GGAGAAAA	GGAGAACA
CNGCGTTA	CAGCGTTA
ATAACGAC	ATAGCGAC
CTGAGCCT	CTGAGCCA
CTATCCTC	CCATCCTC
ATAGCGAT	ATAGCGAC
CGCCTACA	CGCATACA
AGACTAAC	AGGCTAAC
TNGAACAA	TGGAACAA
CTGGCAAA	CTGGCATA
AGGAGATC	AAGAGATC
AAGCGATC	AAGAGATC
AGCAACTC	AGCACCTC
TAGCTTCA	TGGCTTCA
GCATCCTC	CCATCCTC
ATCACCTC	AGCACCTC
CTGAGCCG	CTGAGCCA
ACCACCTC	AGCACCTC
TGAAGTGA	TGAAGAGA
CAGATTGC	CGGATTGC
AAGCTAAC	AGGCTAAC
AGATTTAC	AGATGTAC
CTGAGACA	CTGAGCCA
AGTCATGC	AGCCATGC
CCTGTATC	CCTCTATC
TGCCTTCA	TGGCTTCA
CGCATTGC	CGGATTGC
AGCCTTGC	AGCCATGC
TTACGCAA	GTACGCAA
TNTTCACA	TCTTCACA
GGGAACAA	TGGAACAA
TGGTTGTA	TGGTGGTA
CCGACAGC	CCGACAAC
GGCCATGC	AGCCATGC
ACTAATCC	CCTAATCC
CGGATTGG	CGGATTGC
CCTAATCT	CCTAATCC
CTGTCATA	CTGGCATA
GAGCTGAC	GAGCTGAA
CCTCTACC	CCTCTATC
CGTATTGC	CGGATTGC
AGAAGTAC	AGATGTAC
AGTACCTC	AGCACCTC
AGCACCCC	AGCACCTC
GGACGCAA	GTACGCAA
GNATCTGA	GAATCTGA
CTCCATGA	CTCAATGA
AGACGTAC	AGATGTAC
TGGGGGTA	TGGTGGTA
TGTCTTCA	TGGCTTCA
CGGTGGTA	TGGTGGTA
CTCAATTA	CTCAATGA
CTGGCATC	CTGGCATA
TGCCATGC	AGCCATGC
CGGACAAC	CCGACAAC
CGACGGGA	CGACTGGA
CGGGTTGC	CGGATTGC
CAATACTA	CAAGACTA
CGACTGTA	CGACTGGA
AGCCTAAC	AGGCTAAC
ATAGTGAC	ATAGCGAC
CGAGACTA	CAAGACTA
AGTCTAAC	AGGCTAAC
GAACTGAA	GAGCTGAA
CAGAGATC	AAGAGATC
AGGTTAAC	AGGCTAAC
GTACTCAA	GTACGCAA
AAGATATC	AAGAGATC
GTACGCGA	GTACGCAA
CGCATATA	CGCATACA
CGGATTAC	CGGATTGC
GCGCTGAA	GAGCTGAA
AGCCGTGC	AGCCATGC
AAAGACTA	CAAGACTA
ATATGTAC	AGATGTAC
CGCAGACA	CGCATACA
CGACTTGA	CGACTGGA
GAGATGAA	GAGCTGAA
AACCTTAC	CACCTTAC
CCTCATCC	CCTAATCC
AACACCTC	AGCACCTC
AGCCATCC	AGCCATGC
AGCCCTGC	AGCCATGC
CAAGACTC	CAAGACTA
CTGACCCA	CTGAGCCA
CCCAATGA	CTCAATGA
AGGCTTCA	TGGCTTCA
ATACCGAC	ATAGCGAC
CCAACAAC	CCGACAAC
CCTAATGC	CCTAATCC
TAGCTGAA	GAGCTGAA
CACGACTA	CAAGACTA
AAAAGATC	AAGAGATC
CCTTCCTC	CCATCCTC
GTAAGCAA	GTACGCAA
GAGCGGAA	GAGCTGAA
CACAATGA	CTCAATGA
CAGCTGAA	GAGCTGAA
AGCGATGC	AGCCATGC
CCTAATTC	CCTAATCC
CCATCCCC	CCATCCTC
CCAGCCTC	CCATCCTC
CAGGACTA	CAAGACTA
CTGACAAC	CCGACAAC
TGGTTTCA	TGGCTTCA
CCTACAAC	CCGACAAC
TGATGGTA	TGGTGGTA
TTGTGGTA	TGGTGGTA
AGATGTAT	AGATGTAC
TACCTTAC	CACCTTAC
AGCCATGT	AGCCATGC
AAATGTAC	AGATGTAC
TGGCATCA	TGGCTTCA
ACGACAAC	CCGACAAC
AAGAGATT	AAGAGATC
GGTGCGGA	GGTGCGAA
CGCCTTAC	CACCTTAC
CCCACAAC	CCGACAAC
GNAGAACA	GGAGAACA
GGCATACA	CGCATACA
AAGAGAAC	AAGAGATC
CTCAGTGA	CTCAATGA
CTTAATCC	CCTAATCC
GCCAAGAA	GCCAAGAC
CCCATACA	CGCATACA
GGGATTGC	CGGATTGC
GTCTGTAA	GTCTGTCA
TGAACAGA	TGAAGAGA
CGTAATCC	CCTAATCC
AAGAGGTC	AAGAGATC
GNTCGGTA	GCTCGGTA
CCACTGGA	CGACTGGA
GTCAATGA	CTCAATGA
ACGCTAAC	AGGCTAAC
CAAAACTA	CAAGACTA
CGTCTGGA	CGACTGGA
ATAGCGTC	ATAGCGAC
CGGATTGT	CGGATTGC
ATGGCATA	CTGGCATA
GGATGTAC	AGATGTAC
CACCTTGC	CACCTTAC
CTAGCATA	CTGGCATA
CTGAGGCA	CTGAGCCA
AAGAGTTC	AAGAGATC
GAATCTAA	GAATCTGA
CCTCTTTC	CCTCTATC
AAAGCGAC	ATAGCGAC
AAGCTGAA	GAGCTGAA
CCTCAATC	CCTCTATC
CTGACATA	CTGGCATA
CCATCCAC	CCATCCTC
CCGATTGC	CGGATTGC
TGATGTAC	AGATGTAC
GAGCCGAA	GAGCTGAA
TGGCTTTA	TGGCTTCA
GGTTCGAA	GGTGCGAA
CGGGCATA	CTGGCATA
TGGTGGCA	TGGTGGTA
GNTGAATC	GATGAATC
GACCTGAA	GAGCTGAA
CTCTATGA	CTCAATGA
AGGTGGTA	TGGTGGTA
GTGCGCAA	GTACGCAA
AGGCTATC	AGGCTAAC
GAGTTGAA	GAGCTGAA
CTACGCAA	GTACGCAA
GGTGCGAC	GGTGCGAA
CACCTTAT	CACCTTAC
GTTGCGAA	GGTGCGAA
CTCGATGA	CTCAATGA
CCGTCAAC	CCGACAAC
CAAGTCTA	CAAGACTA
TTGGCATA	CTGGCATA
CCATCATC	CCATCCTC
CCATCCTT	CCATCCTC
CTCATTGA	CTCAATGA
GAGCTGAT	GAGCTGAA
TTCACGCC	TTCACGCA
ACGAGATC	AAGAGATC
AGCACCAC	AGCACCTC
TCGACAAC	CCGACAAC
TAGTGGTA	TGGTGGTA
GGTCCGAA	GGTGCGAA
CTTAATGA	CTCAATGA
CCTATTCC	CCTAATCC
CGGAGTGC	CGGATTGC
AGTGCGAA	GGTGCGAA
CACATTAC	CACCTTAC
GCTGCGAA	GGTGCGAA
CCGGCAAC	CCGACAAC
AGGGTAAC	AGGCTAAC
CAGCTTAC	CACCTTAC
GTGCTGAA	GAGCTGAA
TGCTGGTA	TGGTGGTA
GAGCTGCA	GAGCTGAA
ACAGCGAC	ATAGCGAC
AACAGATC	AAGAGATC
GGGCTAAC	AGGCTAAC
AAGGGATC	AAGAGATC
CAAGACGA	CAAGACTA
CAACTTAC	CACCTTAC
CGCAAACA	CGCATACA
AGCACCTT	AGCACCTC
TCGCTTCA	TGGCTTCA
CAGACAAC	CCGACAAC
CGCTTACA	CGCATACA
CGCGTACA	CGCATACA
GNCTGTCA	GTCTGTCA
TGGCTAAC	AGGCTAAC
ATACGCAA	GTACGCAA
ANAGATTC	ACAGATTC
AGATGTTC	AGATGTAC
GAAGCTGA	GAATCTGA
CCGACATC	CCGACAAC
GTAGCGAC	ATAGCGAC
GTATGCAA	GTACGCAA
GTCCGCAA	GTACGCAA
CGAGTGGA	CGACTGGA
GGTACGAA	GGTGCGAA
GGCACCTC	AGCACCTC
GTCGTAAA	GTCGTAGA
TGGGTTCA	TGGCTTCA
GGGGCGAA	GGTGCGAA
CAAGGCTA	CAAGACTA
AGAGGTAC	AGATGTAC
AGGCAAAC	AGGCTAAC
GATGCGAA	GGTGCGAA
AATAGATC	AAGAGATC
AAGAGACC	AAGAGATC
ATTGCGAC	ATAGCGAC
AGTTGTAC	AGATGTAC
CCGACCAC	CCGACAAC
GTACGCAT	GTACGCAA
CGGATTCC	CGGATTGC
ATAGGGAC	ATAGCGAC
AACTCACA	AACTCACC
TGACACAC	CGACACAC
AGGCTCAC	AGGCTAAC
CCGACAAT	CCGACAAC
CTCAATGT	CTCAATGA
CGACTGCA	CGACTGGA
CCCCTTAC	CACCTTAC
CTCGCATA	CTGGCATA
TGTTGGTA	TGGTGGTA
GGGCTTCA	TGGCTTCA
CCGAATCC	CCTAATCC
CCTTATCC	CCTAATCC
GCTAATCC	CCTAATCC
ACATGTAC	AGATGTAC
AGCACTTC	AGCACCTC
CCAGACTA	CAAGACTA
CGCATCCA	CGCATACA
CTGGCAGA	CTGGCATA
CTGGTATA	CTGGCATA
GTCGTAGC	GTCGTAGA
GAGCTGAG	GAGCTGAA
TGGTGGTT	TGGTGGTA
AAGTGATC	AAGAGATC
ACACTACC	ACACGACC
CAACACTA	CAAGACTA
AGATGTCC	AGATGTAC
CCCAATCC	CCTAATCC
CATAATCC	CCTAATCC
CCAAATCC	CCTAATCC
AGGCTTAC	AGGCTAAC
CTCAATCA	CTCAATGA
TGGTGGTG	TGGTGGTA
CACCCTAC	CACCTTAC
CGACCGGA	CGACTGGA
GGCGCGAA	GGTGCGAA
CCGACACC	CCGACAAC
TGGCTTCT	TGGCTTCA
GAAGACTA	CAAGACTA
TTAGCGAC	ATAGCGAC
ACACGAAC	ACACGACC
GGGTGGTA	TGGTGGTA
CCATCTTC	CCATCCTC
CCGATAAC	CCGACAAC
CCTAATAC	CCTAATCC
TGGCTTCG	TGGCTTCA
CACTTTAC	CACCTTAC
ATAGCTAC	ATAGCGAC
CCTCTGTC	CCTCTATC
GGCGTAGA	GTCGTAGA
AGGCTACC	AGGCTAAC
GAGGTGAA	GAGCTGAA
TCTTCACC	TCTTCACA
GNCAAGAC	GCCAAGAC
CACCGTAC	CACCTTAC
CTGGGATA	CTGGCATA
CAAGCCTA	CAAGACTA
GGTGCGCA	GGTGCGAA
GAACGCAA	GTACGCAA
TGGCTCCA	TGGCTTCA
ATAGCGAG	ATAGCGAC
TGCACCTC	AGCACCTC
GACCTTAC	CACCTTAC
CGACACAT	CGACACAC
CTGCCATA	CTGGCATA
TAGCGTTA	CAGCGTTA
GAGAGATC	AAGAGATC
ANCTCACC	AACTCACC
AGCACATC	AGCACCTC
GAGCTGTA	GAGCTGAA
CAAGACTT	CAAGACTA
CTGGCCTA	CTGGCATA
AGGCTGAC	AGGCTAAC
CCTCTATG	CCTCTATC
CGCCACAC	CGACACAC
TGGCACAA	TGGAACAA
ATAGAGAC	ATAGCGAC
GGTGGGAA	GGTGCGAA
CTGGCATT	CTGGCATA
AATGAATC	GATGAATC
CGACAGGA	CGACTGGA
GTGGCATA	CTGGCATA
GGAGCGAA	GGTGCGAA
CTGGAATA	CTGGCATA
CAGGCATA	CTGGCATA
CCTACTCC	CCTAATCC
AGATATAC	AGATGTAC
CACCTTCC	CACCTTAC
ATGAGATC	AAGAGATC
AGACACAC	CGACACAC
ACCCGACC	ACACGACC
CCTAGTCC	CCTAATCC
GTCTTAGA	GTCGTAGA
CTCACTGA	CTCAATGA
TTGACGCA	TTCACGCA
CCTGATCC	CCTAATCC
GGTGAGAA	GGTGCGAA
ACGCGACC	ACACGACC
GCGACAAC	CCGACAAC
TCGTGGTA	TGGTGGTA
AGCCACGC	AGCCATGC
GCACGCAA	GTACGCAA
GTCGTAGG	GTCGTAGA
GGTGCCAA	GGTGCGAA
TGCACGCA	TTCACGCA
TTAACGCA	TTCACGCA
TAGAGATC	AAGAGATC
GTACGCTA	GTACGCAA
CGGCACAC	CGACACAC
CATCTTAC	CACCTTAC
TTCACGGA	TTCACGCA
TGGGACAA	TGGAACAA
GTACGCAG	GTACGCAA
CGGACTGC	CGGATTGC
CTAGACTA	CAAGACTA
GAGCAGAA	GAGCTGAA
TGGCTGCA	TGGCTTCA
GAATCTGC	GAATCTGA
GAATCTGG	GAATCTGA
TGGAACGA	TGGAACAA
AGACGACC	ACACGACC
GGATCTGA	GAATCTGA
CGGCGTTA	CAGCGTTA
CAGCGTTC	CAGCGTTA
GTACGTAA	GTACGCAA
CGATACAC	CGACACAC
GGTGTGAA	GGTGCGAA
CCGAGAAC	CCGACAAC
GTACACAA	GTACGCAA
CAAGACCA	CAAGACTA
TGGTAGTA	TGGTGGTA
CCGGCATA	CTGGCATA
CTACACAC	CGACACAC
CGACACGC	CGACACAC
CAAGACTG	CAAGACTA
GTAGGCAA	GTACGCAA
CCACGACC	ACACGACC
CGGAATGC	CGGATTGC
TTTACGCA	TTCACGCA
AAGAAATC	AAGAGATC
CTCAACGA	CTCAATGA
GTACCCAA	GTACGCAA
GAGCTTAA	GAGCTGAA
TGGTGTTA	TGGTGGTA
GGTGCGAG	GGTGCGAA
GGGGAACA	GGAGAACA
GCTCGGTC	GCTCGGTA
AAGCGTTA	CAGCGTTA
ACAGTTTC	ACAGATTC
ACAGCTTC	ACAGATTC
CTGGCATG	CTGGCATA
CACCTTTC	CACCTTAC
TTCATGCA	TTCACGCA
CGCATTCA	CGCATACA
CTCCTTAC	CACCTTAC
CAACACAC	CGACACAC
CCATCCTG	CCATCCTC
CTCACGCA	TTCACGCA
GGTGCGAT	GGTGCGAA
GTGGTAGA	GTCGTAGA
ATACGACC	ACACGACC
CCGAAAAC	CCGACAAC
CTGGCACA	CTGGCATA
GTAGTAGA	GTCGTAGA
ACACGAGC	ACACGACC
TGTTCACA	TCTTCACA
AGATGTAG	AGATGTAC
CATGACTA	CAAGACTA
TGGAACAC	TGGAACAA
CAGAGTTA	CAGCGTTA
CGCATACT	CGCATACA
GTCATAGA	GTCGTAGA
GCTCGGGA	GCTCGGTA
TTCACTCA	TTCACGCA
TTCACGTA	TTCACGCA
CCTAACCC	CCTAATCC
ACAAGACC	ACACGACC
GTCTGTCC	GTCTGTCA
GGTGAATC	GATGAATC
CAAGATTA	CAAGACTA
TGGAACCA	TGGAACAA
ACATGACC	ACACGACC
CACGTTAC	CACCTTAC
CGCATACG	CGCATACA
CACCATAC	CACCTTAC
CAGTGTTA	CAGCGTTA
GGAGAACC	GGAGAACA
TTGAACAA	TGGAACAA
GGCTGTCA	GTCTGTCA
CAGCGTGA	CAGCGTTA
CATGAATC	GATGAATC
TTCGTAGA	GTCGTAGA
GGTGCTAA	GGTGCGAA
GTACGGAA	GTACGCAA
CGGATCGC	CGGATTGC
AAGACATC	AAGAGATC
TGAAACAA	TGGAACAA
CGGAACAA	TGGAACAA
CCGACTAC	CCGACAAC
CGACTAGA	CGACTGGA
TTCCCGCA	TTCACGCA
AGATCTAC	AGATGTAC
GGTGCGTA	GGTGCGAA
ATAGCAAC	ATAGCGAC
AGCACCTG	AGCACCTC
CTCGTAGA	GTCGTAGA
CAACGTTA	CAGCGTTA
GTTCGCAA	GTACGCAA
AAACGACC	ACACGACC
GCTCGGAA	GCTCGGTA
TCTTCAGA	TCTTCACA
CAAGAATA	CAAGACTA
CCTTCACA	TCTTCACA
CGAAACAC	CGACACAC
GAATTTGA	GAATCTGA
TGGTACAA	TGGAACAA
ACACGATC	ACACGACC
CGACATAC	CGACACAC
CGACACCC	CGACACAC
AAGAGATG	AAGAGATC
GAGTCTGA	GAATCTGA
GACTCTGA	GAATCTGA
AGGCTAAG	AGGCTAAC
GCTTGGTA	GCTCGGTA
CAGCTTTA	CAGCGTTA
GACGTAGA	GTCGTAGA
ATCGTAGA	GTCGTAGA
ACAGGTTC	ACAGATTC
CCGACGAC	CCGACAAC
TCGTCACA	TCTTCACA
GGACACAC	CGACACAC
TCCTCACA	TCTTCACA
GATGAATT	GATGAATC
ACACGACT	ACACGACC
TGGTCGTA	TGGTGGTA
TGGAATAA	TGGAACAA
TATTCACA	TCTTCACA
CTGGCGTA	CTGGCATA
CGCATGCA	CGCATACA
CAGCGGTA	CAGCGTTA
CACTTCNA	CACTTCGA
CCGACAAG	CCGACAAC
TGCAACAA	TGGAACAA
GAATCTTA	GAATCTGA
GATAAATC	GATGAATC
CACCGTTA	CAGCGTTA
GCTCTGTA	GCTCGGTA
CAATCTGA	GAATCTGA
TAATCTGA	GAATCTGA
CCATCGTC	CCATCCTC
ATCACGCA	TTCACGCA
CTGGCTTA	CTGGCATA
GGCGAACA	GGAGAACA
TGGAACAT	TGGAACAA
GCATCTGA	GAATCTGA
GGAGTACA	GGAGAACA
GAAACTGA	GAATCTGA
CCACACAC	CGACACAC
TAGAACAA	TGGAACAA
TCTTCCCA	TCTTCACA
TCTACACA	TCTTCACA
TTCAAGCA	TTCACGCA
AGATGCAC	AGATGTAC
AGCACGTC	AGCACCTC
TCTTCACT	TCTTCACA
TGAGAACA	GGAGAACA
GTATCTGA	GAATCTGA
AGCCAGGC	AGCCATGC
GTCTTTCA	GTCTGTCA
GTGTGTCA	GTCTGTCA
TGGCTACA	TGGCTTCA
GGAGGACA	GGAGAACA
AAATCTGA	GAATCTGA
TCATCACA	TCTTCACA
CCGCGTTA	CAGCGTTA
GTCTGTGA	GTCTGTCA
TCTCCACA	TCTTCACA
GTTGTAGA	GTCGTAGA
GCTGAATC	GATGAATC
GATTAATC	GATGAATC
GCTAGGTA	GCTCGGTA
ATAGCCAC	ATAGCGAC
CGACACTC	CGACACAC
GTCCTAGA	GTCGTAGA
TACACGCA	TTCACGCA
ACACGCCC	ACACGACC
GCCCGGTA	GCTCGGTA
GGTCGGTA	GCTCGGTA
GTTCGGTA	GCTCGGTA
CATCGTTA	CAGCGTTA
TGGAGCAA	TGGAACAA
CGAGAACA	GGAGAACA
TCTTTACA	TCTTCACA
AGGAACAA	TGGAACAA
GCGCGGTA	GCTCGGTA
AGAGAACA	GGAGAACA
CGACTCAC	CGACACAC
CCTAATCG	CCTAATCC
CACCTCAC	CACCTTAC
ACTTCACA	TCTTCACA
GTCGGAGA	GTCGTAGA
TGTAACAA	TGGAACAA
ACACCACC	ACACGACC
CCTCGGTA	GCTCGGTA
AGCTCACC	AACTCACC
GGAGCACA	GGAGAACA
CAGCGTTT	CAGCGTTA
TTCAGGCA	TTCACGCA
ACATATTC	ACAGATTC
GAGCGTTA	CAGCGTTA
TTTTCACA	TCTTCACA
GAACCTGA	GAATCTGA
CAGCGCTA	CAGCGTTA
GATCAATC	GATGAATC
AGAGATTC	ACAGATTC
TCTCGGTA	GCTCGGTA
AGATGGAC	AGATGTAC
ACACAACC	ACACGACC
GCCGTAGA	GTCGTAGA
CGTCACAC	CGACACAC
GGATAACA	GGAGAACA
GTAGAACA	GGAGAACA
ACTCGACC	ACACGACC
GGAAAACA	GGAGAACA
GTATGTCA	GTCTGTCA
GATGAAAC	GATGAATC
TTCACGCT	TTCACGCA
CCTAAACC	CCTAATCC
GAGGAATC	GATGAATC
TTCTGTCA	GTCTGTCA
TTCGCGCA	TTCACGCA
TCCACGCA	TTCACGCA
AGCCAAGC	AGCCATGC
TGGATCAA	TGGAACAA
AACTCAAC	AACTCACC
GAATCTGT	GAATCTGA
TTCACGCG	TTCACGCA
ACAGATTT	ACAGATTC
GTCGTATA	GTCGTAGA
CACCTTAG	CACCTTAC
TTCTCGCA	TTCACGCA
CTCTGTCA	GTCTGTCA
GCACGACC	ACACGACC
CCAGATTC	ACAGATTC
GCTCGGTT	GCTCGGTA
GATCGGTA	GCTCGGTA
CTGCGTTA	CAGCGTTA
TCTTCACG	TCTTCACA
GGAGAAGA	GGAGAACA
ACCGATTC	ACAGATTC
TGGAACTA	TGGAACAA
ACTCGGTA	GCTCGGTA
GCCAAGGC	GCCAAGAC
GAAGAACA	GGAGAACA
CAGGGTTA	CAGCGTTA
TATGAATC	GATGAATC
GAAGAATC	GATGAATC
CAAGAGTA	CAAGACTA
GATGAAGC	GATGAATC
CGACTCGA	CGACTGGA
ACGGATTC	ACAGATTC
GCACGGTA	GCTCGGTA
GACGAATC	GATGAATC
CACTCACC	AACTCACC
TCACGACC	ACACGACC
ACAAATTC	ACAGATTC
GTCGTAGT	GTCGTAGA
AAAGATTC	ACAGATTC
ATCTGTCA	GTCTGTCA
ACAGGACC	ACACGACC
GTCGTCGA	GTCGTAGA
CTCAAAGA	CTCAATGA
GACTGTCA	GTCTGTCA
GTCGTACA	GTCGTAGA
GCCCAGAC	GCCAAGAC
GCTCAGTA	GCTCGGTA
GTCGTTGA	GTCGTAGA
TGGTGATA	TGGTGGTA
CGACCCAC	CGACACAC
GCTCGGCA	GCTCGGTA
CGACGCAC	CGACACAC
CCTAAGCC	CCTAATCC
GCCAAGAT	GCCAAGAC
ATAGATTC	ACAGATTC
GAATGTGA	GAATCTGA
GAATATGA	GAATCTGA
ACCTCACC	AACTCACC
GTCACGCA	TTCACGCA
TCTTCATA	TCTTCACA
TCGAACAA	TGGAACAA
GTCAGTCA	GTCTGTCA
GTTTGTCA	GTCTGTCA
GTCTGTTA	GTCTGTCA
CGGATGGC	CGGATTGC
GATGTATC	GATGAATC
GCCTGTCA	GTCTGTCA
CGAGACAC	CGACACAC
TCTTGACA	TCTTCACA
GCTCGGTG	GCTCGGTA
GGACAACA	GGAGAACA
GGCAAGAC	GCCAAGAC
ACAGATGC	ACAGATTC
GATGGATC	GATGAATC
GCTAAGAC	GCCAAGAC
CTCAAGGA	CTCAATGA
CAGCGTTG	CAGCGTTA
AACTCAGC	AACTCACC
CGACAAAC	CGACACAC
GCAAAGAC	GCCAAGAC
GGAGAATA	GGAGAACA
GCGAAGAC	GCCAAGAC
TCTGCACA	TCTTCACA
GTCCGTCA	GTCTGTCA
TGGAACAG	TGGAACAA
AACCCACC	AACTCACC
TCTTAACA	TCTTCACA
CAGCATTA	CAGCGTTA
AAGTCACC	AACTCACC
CAGCGTCA	CAGCGTTA
AAATCACC	AACTCACC
ACACATTC	ACAGATTC
GCTTCACA	TCTTCACA
TGAAGANA	TGAAGAGA
TCCAAGAC	GCCAAGAC
ACACGGCC	ACACGACC
GATTCTGA	GAATCTGA
GTCGCAGA	GTCGTAGA
ACCAAGAC	GCCAAGAC
GGTGAACA	GGAGAACA
GTTGAATC	GATGAATC
TTCACACA	TTCACGCA
GATGCATC	GATGAATC
GTCAAGAC	GCCAAGAC
GCAGAACA	GGAGAACA
AACACACC	AACTCACC
CAGCGATA	CAGCGTTA
CCCAAGAC	GCCAAGAC
ACACGTCC	ACACGACC
AACTCACT	AACTCACC
GCTGGGTA	GCTCGGTA
TGGACCAA	TGGAACAA
CTGAGCNA	CTGAGCCA
GTCTATCA	GTCTGTCA
GTCGTGGA	GTCGTAGA
GTCTGCCA	GTCTGTCA
TTCACCCA	TTCACGCA
AGATGAAC	AGATGTAC
TGGAAGAA	TGGAACAA
GATGAACC	GATGAATC
GGAGAACG	GGAGAACA
GACAAGAC	GCCAAGAC
GATGACTC	GATGAATC
ACACGACG	ACACGACC
TCTTCTCA	TCTTCACA
GAATCTCA	GAATCTGA
GCCAAGCC	GCCAAGAC
CACTTNGA	CACTTCGA
TGGTGCTA	TGGTGGTA
GTCTGTCT	GTCTGTCA
GTCGAAGA	GTCGTAGA
AACTCATC	AACTCACC
ATCTCACC	AACTCACC
TCTTCGCA	TCTTCACA
GGAGAACT	GGAGAACA
ACAGATCC	ACAGATTC
GAGCTCAA	GAGCTGAA
CAGCCTTA	CAGCGTTA
GCTCGATA	GCTCGGTA
AACTTACC	AACTCACC
CCTCTANC	CCTCTATC
GTCTGTCG	GTCTGTCA
ACTGATTC	ACAGATTC
CGGATAGC	CGGATTGC
CACCTGAC	CACCTTAC
GACTCACC	AACTCACC
GTCGGTCA	GTCTGTCA
GCAGATTC	ACAGATTC
GTCTGGCA	GTCTGTCA
GATGAATG	GATGAATC
GCCAATAC	GCCAAGAC
AACTCCCC	AACTCACC
ACAGATAC	ACAGATTC
CGACAGAC	CGACACAC
AGCCATNC	AGCCATGC
GCTCGTTA	GCTCGGTA
GCCAAGTC	GCCAAGAC
GCCGAGAC	GCCAAGAC
GATGAGTC	GATGAATC
TCAGATTC	ACAGATTC
GCCTAGAC	GCCAAGAC
GCTCCGTA	GCTCGGTA
AACGCACC	AACTCACC
CGACACAG	CGACACAC
GGAGACCA	GGAGAACA
TACTCACC	AACTCACC
CACCTAAC	CACCTTAC
GCCAGGAC	GCCAAGAC
GAATCCGA	GAATCTGA
GCCATGAC	GCCAAGAC
GCCACGAC	GCCAAGAC
CCATCCNC	CCATCCTC
GGAGAGCA	GGAGAACA
ACAGATTG	ACAGATTC
CGCATANA	CGCATACA
AACTAACC	AACTCACC
GTCTCTCA	GTCTGTCA
ACAGACTC	ACAGATTC
GATGATTC	GATGAATC
AATTCACC	AACTCACC
AACTGACC	AACTCACC
CGACTGNA	CGACTGGA
TGGCTTNA	TGGCTTCA
CGGATTNC	CGGATTGC
ACAGAGTC	ACAGATTC
CTCAATNA	CTCAATGA
AGATGTNC	AGATGTAC
AGGCTANC	AGGCTAAC
TGAAGNGA	TGAAGAGA
ATAGCGNC	ATAGCGAC
GTCTGACA	GTCTGTCA
AGCACCNC	AGCACCTC
GAGCTGNA	GAGCTGAA
GCCAAGAG	GCCAAGAC
CTGAGNCA	CTGAGCCA
GGAGATCA	GGAGAACA
ACAGAATC	ACAGATTC
GCCAAAAC	GCCAAGAC
TGGTGGNA	TGGTGGTA
AAGAGANC	AAGAGATC
AACTCACG	AACTCACC
CAAGACNA	CAAGACTA
CCGACANC	CCGACAAC
CCTCTNTC	CCTCTATC
AGCCANGC	AGCCATGC
GCCAACAC	GCCAAGAC
GAATCGGA	GAATCTGA
CCTAATNC	CCTAATCC
CTGGCANA	CTGGCATA
AACTCTCC	AACTCACC
GTACGCNA	GTACGCAA
AACTCGCC	AACTCACC
CACTTCGN	CACTTCGA
CACCTTNC	CACCTTAC
GCTCGCTA	GCTCGGTA
CCATCNTC	CCATCCTC
CTCAANGA	CTCAATGA
CGACTNGA	CGACTGGA
ATAGCNAC	ATAGCGAC
CGGATNGC	CGGATTGC
TGGCTNCA	TGGCTTCA
CGCATNCA	CGCATACA
GGTGCGNA	GGTGCGAA
TGGAACNA	TGGAACAA
AGCACNTC	AGCACCTC
AGGCTNAC	AGGCTAAC
ACACGANC	ACACGACC
TGAAGAGN	TGAAGAGA
AGATGNAC	AGATGTAC
TTCACGNA	TTCACGCA
CGACACNC	CGACACAC
GAGCTNAA	GAGCTGAA
CAAGANTA	CAAGACTA
TGGTGNTA	TGGTGGTA
CAGCGTNA	CAGCGTTA
GAATCAGA	GAATCTGA
GTACGNAA	GTACGCAA
AAGAGNTC	AAGAGATC
CCGACNAC	CCGACAAC
TCTTCANA	TCTTCACA
GTCGTANA	GTCGTAGA
GATGAANC	GATGAATC
CTGGCNTA	CTGGCATA
GAATCTNA	GAATCTGA
CACCTNAC	CACCTTAC
CTGAGCCN	CTGAGCCA
CCTAANCC	CCTAATCC
GGTGCNAA	GGTGCGAA
GTCTGTNA	GTCTGTCA
GGAGAANA	GGAGAACA
GCTCGGNA	GCTCGGTA
AGCCATGN	AGCCATGC
TCTTCNCA	TCTTCACA
CCTCTATN	CCTCTATC
ACAGATNC	ACAGATTC
GTCGTNGA	GTCGTAGA
TGGCTTCN	TGGCTTCA
TTCACNCA	TTCACGCA
CCATCCTN	CCATCCTC
GCCAAGNC	GCCAAGAC
CGACANAC	CGACACAC
CGCATACN	CGCATACA
CGACTGGN	CGACTGGA
CGGATTGN	CGGATTGC
AACTCANC	AACTCACC
ACACGNCC	ACACGACC
ATAGCGAN	ATAGCGAC
GCTCGNTA	GCTCGGTA
AGGCTAAN	AGGCTAAC
CTCAATGN	CTCAATGA
AGCACCTN	AGCACCTC
GAATCNGA	GAATCTGA
TGGAANAA	TGGAACAA
CAGCGNTA	CAGCGTTA
AGATGTAN	AGATGTAC
CCGACAAN	CCGACAAC
AAGAGATN	AAGAGATC
GAGCTGAN	GAGCTGAA
GTACGCAN	GTACGCAA
ACAGANTC	ACAGATTC
TGGTGGTN	TGGTGGTA
CACCTTAN	CACCTTAC
GTCTGNCA	GTCTGTCA
GCCAANAC	GCCAAGAC
CTGGCATN	CTGGCATA
GGAGAACN	GGAGAACA
CCTAATCN	CCTAATCC
GGAGANCA	GGAGAACA
CAAGACTN	CAAGACTA
TTCACGCN	TTCACGCA
GCTCGGTN	GCTCGGTA
ACACGACN	ACACGACC
GATGANTC	GATGAATC
GTCGTAGN	GTCGTAGA
CAGCGTTN	CAGCGTTA
GGTGCGAN	GGTGCGAA
TCTTCACN	TCTTCACA
TGGAACAN	TGGAACAA
GTCTGTCN	GTCTGTCA
GAATCTGN	GAATCTGA
CGACACAN	CGACACAC
AACTCNCC	AACTCACC
AACTCACN	AACTCACC
ACAGATTN	ACAGATTC
GATGAATN	GATGAATC
