CACTTCGA	CACTTCGA
TGAAGAGA	TGAAGAGA
CTGAGCCA	CTGAGCCA
CCTCTATC	CCTCTATC
AGCCATGC	AGCCATGC
CCATCCTC	CCATCCTC
TGGCTTCA	TGGCTTCA
CGCATACA	CGCATACA
CGACTGGA	CGACTGGA
CGGATTGC	CGGATTGC
AGGCTAAC	AGGCTAAC
CTCAATGA	CTCAATGA
ATAGCGAC	ATAGCGAC
AGCACCTC	AGCACCTC
AGATGTAC	AGATGTAC
GAGCTGAA	GAGCTGAA
AAGAGATC	AAGAGATC
CCGACAAC	CCGACAAC
TGGTGGTA	TGGTGGTA
CAAGACTA	CAAGACTA
GTACGCAA	GTACGCAA
CACCTTAC	CACCTTAC
CTGGCATA	CTGGCATA
CCTAATCC	CCTAATCC
GGTGCGAA	GGTGCGAA
TTCACGCA	TTCACGCA
ACACGACC	ACACGACC
CGACACAC	CGACACAC
GTCGTAGA	GTCGTAGA
TGGAACAA	TGGAACAA
CAGCGTTA	CAGCGTTA
TCTTCACA	TCTTCACA
GAATCTGA	GAATCTGA
GCTCGGTA	GCTCGGTA
GGAGAACA	GGAGAACA
GATGAATC	GATGAATC
GTCTGTCA	GTCTGTCA
ACAGATTC	ACAGATTC
AACTCACC	AACTCACC
GCCAAGAC	GCCAAGAC
TGAAGTGA	TGAAGAGA
ATCACCTC	AGCACCTC
CGCAATGA	CTCAATGA
CTGAGTCA	CTGAGCCA
CGGTGGTA	TGGTGGTA
TTCAATGA	CTCAATGA
TACCTTAC	CACCTTAC
GAGCTGAC	GAGCTGAA
GTGCTGAA	GAGCTGAA
CTATCCTC	CCATCCTC
TTGCTTCA	TGGCTTCA
CTCATACA	CGCATACA
GGCGTAGA	GTCGTAGA
AAGAGTTC	AAGAGATC
CCTCTTTC	CCTCTATC
AAGAGCTC	AAGAGATC
CCTCGGTA	GCTCGGTA
CGATCCTC	CCATCCTC
GGACGCAA	GTACGCAA
TTGTGGTA	TGGTGGTA
ATAGCTAC	ATAGCGAC
AGCACCCC	AGCACCTC
ATATGTAC	AGATGTAC
GGACTGGA	CGACTGGA
ATGCTAAC	AGGCTAAC
TTACGCAA	GTACGCAA
CGATGTAC	AGATGTAC
AGCACTTC	AGCACCTC
CTCAATGG	CTCAATGA
CTCCTTAC	CACCTTAC
CCATCTTC	CCATCCTC
TGGCTAAC	AGGCTAAC
ATGAGATC	AAGAGATC
CTAGACTA	CAAGACTA
AGTCTAAC	AGGCTAAC
TAGCGTTA	CAGCGTTA
CCCAATGA	CTCAATGA
TTGAACAA	TGGAACAA
GGTGCGAC	GGTGCGAA
GGTGCTAA	GGTGCGAA
AGAGCGAC	ATAGCGAC
CTGATTGC	CGGATTGC
GATGAATA	GATGAATC
TAAGACTA	CAAGACTA
GTTCGGTA	GCTCGGTA
GGCACCTC	AGCACCTC
CTCCATGA	CTCAATGA
GGGCTGAA	GAGCTGAA
ATAGCGCC	ATAGCGAC
GTACGTAA	GTACGCAA
GGGCTTCA	TGGCTTCA
CACAATGA	CTCAATGA
GTATCTGA	GAATCTGA
GTACGCAC	GTACGCAA
CTGGCATC	CTGGCATA
CAGCTGAA	GAGCTGAA
GCTAATCC	CCTAATCC
CGACTTGA	CGACTGGA
AGATTTAC	AGATGTAC
TGTAGAGA	TGAAGAGA
CAAGACTC	CAAGACTA
CAGAGATC	AAGAGATC
CCGCCAAC	CCGACAAC
CGCATTCA	CGCATACA
GGAAGAGA	TGAAGAGA
CCTCTCTC	CCTCTATC
TTCGTAGA	GTCGTAGA
ACACTACC	ACACGACC
GGATCTGA	GAATCTGA
TGGCTTCT	TGGCTTCA
CGACTCGA	CGACTGGA
GATTCTGA	GAATCTGA
CGGCTTCA	TGGCTTCA
GACGTAGA	GTCGTAGA
CGGATTGT	CGGATTGC
TTGGCATA	CTGGCATA
AGGCTACC	AGGCTAAC
AAGAGACC	AAGAGATC
CCATCCCC	CCATCCTC
GAATCTAA	GAATCTGA
TGCCATGC	AGCCATGC
TCTCGGTA	GCTCGGTA
TGGCTGCA	TGGCTTCA
AGCCGTGC	AGCCATGC
GCATCCTC	CCATCCTC
CCGACCAC	CCGACAAC
GCGCTGAA	GAGCTGAA
CCCATACA	CGCATACA
TGGCTACA	TGGCTTCA
CGGATTGG	CGGATTGC
AGATGTAT	AGATGTAC
CTCTATGA	CTCAATGA
CCTCCATC	CCTCTATC
TGGTGTTA	TGGTGGTA
TGGTGGCA	TGGTGGTA
GTACGCCA	GTACGCAA
ATACCGAC	ATAGCGAC
CACCTTCC	CACCTTAC
AGGCGAAC	AGGCTAAC
TGTGCGAA	GGTGCGAA
GTCGTAGC	GTCGTAGA
CAAGACCA	CAAGACTA
AGCAGCTC	AGCACCTC
CGAGAACA	GGAGAACA
TGGTGATA	TGGTGGTA
CGCCTACA	CGCATACA
CGGACAAC	CCGACAAC
GTTGCGAA	GGTGCGAA
CGGCTAAC	AGGCTAAC
AGATGTAG	AGATGTAC
CACGACTA	CAAGACTA
CGCACCTC	AGCACCTC
AGGCTTCA	TGGCTTCA
CTGGCCTA	CTGGCATA
CTGACAAC	CCGACAAC
TGGTGGTC	TGGTGGTA
CGGCGTTA	CAGCGTTA
GAATCTGG	GAATCTGA
TGGTGGTT	TGGTGGTA
TCTTCAAA	TCTTCACA
CAACTGGA	CGACTGGA
TCTAATCC	CCTAATCC
ACACGCCC	ACACGACC
ATAGCGGC	ATAGCGAC
CACATACA	CGCATACA
GTCTGTTA	GTCTGTCA
CCGAGCCA	CTGAGCCA
GAATCTGC	GAATCTGA
TGCACGCA	TTCACGCA
GGCTGTCA	GTCTGTCA
CGGGCATA	CTGGCATA
TAGTGGTA	TGGTGGTA
CTCAATTA	CTCAATGA
TGGCTTGA	TGGCTTCA
AGCACCGC	AGCACCTC
GAATCTTA	GAATCTGA
CGCATAGA	CGCATACA
AGATGTCC	AGATGTAC
GAAGCTGA	GAATCTGA
AGCCATAC	AGCCATGC
CCATCATC	CCATCCTC
ATAGCCAC	ATAGCGAC
CGCCTTAC	CACCTTAC
AGCCTAAC	AGGCTAAC
TTCTCGCA	TTCACGCA
CCTCAATC	CCTCTATC
GCAGAACA	GGAGAACA
GAAGAACA	GGAGAACA
CCACCCTC	CCATCCTC
CCCACAAC	CCGACAAC
GGACACAC	CGACACAC
GCCTGTCA	GTCTGTCA
ACAGCGAC	ATAGCGAC
CCCAATCC	CCTAATCC
GAACGCAA	GTACGCAA
CGACTAGA	CGACTGGA
AGCACATC	AGCACCTC
TTCACGCC	TTCACGCA
TTTTCACA	TCTTCACA
CGCATCCA	CGCATACA
GATGGATC	GATGAATC
TACTCACC	AACTCACC
GTCATAGA	GTCGTAGA
CTGACCCA	CTGAGCCA
TCGTGGTA	TGGTGGTA
TTAGCGAC	ATAGCGAC
CCTCGATC	CCTCTATC
CAAGTCTA	CAAGACTA
CCACTGGA	CGACTGGA
CTCGCATA	CTGGCATA
CCTTCACA	TCTTCACA
AAGCGATC	AAGAGATC
CTGAGGCA	CTGAGCCA
CTGAGACA	CTGAGCCA
ACAGGTTC	ACAGATTC
AAGATATC	AAGAGATC
GAGCTGAT	GAGCTGAA
TCCAAGAC	GCCAAGAC
ACAGTTTC	ACAGATTC
CAGCTTTA	CAGCGTTA
CTACGCAA	GTACGCAA
CAAGACTT	CAAGACTA
TGGAGCAA	TGGAACAA
GGAGACCA	GGAGAACA
ATACGACC	ACACGACC
GCTTCACA	TCTTCACA
GATGCGAA	GGTGCGAA
CTCACGCA	TTCACGCA
AGACTAAC	AGGCTAAC
CAAAACTA	CAAGACTA
AACACCTC	AGCACCTC
AAGCTAAC	AGGCTAAC
CTAGCGAC	ATAGCGAC
ACAGATTA	ACAGATTC
GCCAATAC	GCCAAGAC
GGGATTGC	CGGATTGC
GTCGTAAA	GTCGTAGA
ACCCATGC	AGCCATGC
CCGACATC	CCGACAAC
CCAGACTA	CAAGACTA
GGGTGGTA	TGGTGGTA
GCACGCAA	GTACGCAA
TTCACGTA	TTCACGCA
TTCACGAA	TTCACGCA
ATATCGAC	ATAGCGAC
AGACGACC	ACACGACC
ACACGTCC	ACACGACC
ATGGCATA	CTGGCATA
TGACTTCA	TGGCTTCA
GATGCATC	GATGAATC
GCTCAGTA	GCTCGGTA
AGAGGTAC	AGATGTAC
CCCCTTAC	CACCTTAC
CCTTCCTC	CCATCCTC
GGTGCCAA	GGTGCGAA
GTCGTTGA	GTCGTAGA
GACCTTAC	CACCTTAC
GAATCTGT	GAATCTGA
CCAGCCTC	CCATCCTC
ACCAAGAC	GCCAAGAC
AGCTCACC	AACTCACC
TGGTTGTA	TGGTGGTA
AGATATAC	AGATGTAC
GGTGCGTA	GGTGCGAA
CCTCTACC	CCTCTATC
CACCTTGC	CACCTTAC
GCTCGGTG	GCTCGGTA
CGACACAA	CGACACAC
AGCCAGGC	AGCCATGC
ACAGCTTC	ACAGATTC
GGAGATCA	GGAGAACA
TCAAGAGA	TGAAGAGA
CTTAATGA	CTCAATGA
AGCCAAGC	AGCCATGC
CGGAATGC	CGGATTGC
TTCAAGCA	TTCACGCA
CCGGCATA	CTGGCATA
AAAGCGAC	ATAGCGAC
AGCCACGC	AGCCATGC
CGCACACA	CGCATACA
ACTAATCC	CCTAATCC
CCGACAAG	CCGACAAC
CGACTGTA	CGACTGGA
ATCAATGA	CTCAATGA
CCTCTAAC	CCTCTATC
CCTCTATT	CCTCTATC
AGGCTGAC	AGGCTAAC
TGGTGGTG	TGGTGGTA
ACCCGACC	ACACGACC
CCTAATCT	CCTAATCC
TCTTCACC	TCTTCACA
CGCATGCA	CGCATACA
TTCAGGCA	TTCACGCA
CCTAAGCC	CCTAATCC
CCATCGTC	CCATCCTC
CACCTCAC	CACCTTAC
GCATCTGA	GAATCTGA
AGTCATGC	AGCCATGC
CTGGCAAA	CTGGCATA
AGGCTTAC	AGGCTAAC
AAGAGATT	AAGAGATC
AGGCTCAC	AGGCTAAC
TGAAGGGA	TGAAGAGA
CGTGCGAA	GGTGCGAA
CGGCTGGA	CGACTGGA
AGCGCCTC	AGCACCTC
CGCAAACA	CGCATACA
CTGAGCCG	CTGAGCCA
CAGCGTTC	CAGCGTTA
TTGACGCA	TTCACGCA
TAGAGATC	AAGAGATC
CGACACAT	CGACACAC
CGTAATCC	CCTAATCC
GTGGCATA	CTGGCATA
GTATGCAA	GTACGCAA
CGGATTCC	CGGATTGC
CAGCGTTT	CAGCGTTA
GTACTCAA	GTACGCAA
CCATCCTG	CCATCCTC
AGTACCTC	AGCACCTC
ACGCTAAC	AGGCTAAC
GAGCTTAA	GAGCTGAA
CCGACTAC	CCGACAAC
AGGAGATC	AAGAGATC
GCTCGGTC	GCTCGGTA
CTGAGCCT	CTGAGCCA
GAGTTGAA	GAGCTGAA
GCCAAGAA	GCCAAGAC
AGGCCAAC	AGGCTAAC
GTACGCGA	GTACGCAA
CTACACAC	CGACACAC
GGAGAAAA	GGAGAACA
CTGGGATA	CTGGCATA
GGTGAGAA	GGTGCGAA
CACTTTAC	CACCTTAC
TCTTCACT	TCTTCACA
TGGCTTTA	TGGCTTCA
CAAGATTA	CAAGACTA
